6,6,
WWWWWW
WWGGGW
WGGWGW
W*WWGW
WWSGGW
WWWWWW