5,5,
WWWWW
W*GGW
WWWGW
WWWSW
WWWWW