6,6,
WWWWWW
WGGGWW
WGWGGW
WGWWGW
W*WSGW
WWWWWW